1111111111111101
1000000000000001
1011100101001101
1010100001000001
1000001000001111
1010101101000001
1000101100110101
1000000010000101
1100110111010001
1000000100001011
1011100111001011
1001110100001101
1001000100001001
1001010001111011
1000000000000001
1011111111111111